# # # . # # # . . # # . . # # # . # # # # # # . # # # . # # # . . # # . . . # # . # . # # . # # . # # # . . . . # # . . . # # # . . . . . . . . # . # # # . # . # # . . . # # . . # # # # # . . # . . # . . # . . # . # # . . # # . . # . # # #
. . . # . . . . . . . . . . . . # . . . . . . . . . . . . . . # . . . # # . . # . . . # # . . . . # . . . . . . # . . . . . . . . . # . . . . # . . . . . # . . # . . # # . . . # . . . . # . # . . . . # . . . . . . # . . . . . . # . . . . #
. . . . . # . . . # # . . . # . . . . . # . # # . . . . # # . . # . . . . . . . . . # . . . . . . # . . . # . # . . # . # # # . . . # . . # # . . . . . . . . . . . . . . . . # . . # # # . . # . . # . # # . # . . . . # . . # . . . . # . . #
. . # . . . . . # # # # . . . . . # . . . # # . # # . # . # . . . # . . . . # . # # . . . . . . . # . . . . . . # . . . # . . . . . . . . # . . . . . . . . . # . # . . . . # . . . # . . . . . # . # . . . . # # # . . . # . . . # # . . . . #
# . . . . . . . . # # . . . . . . . . # . . . . # # . . . . . . . . . . . . . # # # . # . . . . . # . . . . . . . . . # # . . # . . . . . # . . # # . . . # . . # . . . . . . . . . # . . . # . . . # # . # . . . . . . . . . . . # . . # . . .
. . . . . . . . . # # . . . . . . . . . . # . . . . . . . . . . . . . . . . # . # . . . . . # . . # # . . . . . # . . . # . . . . . # . # # . . . . . . . . . # . # . . . . . . . . # . . . . . . . # . # . . . . . . . . . . # # . # # # # # .
# # . . . # . . . . . . . . # . . . # # . . . # . . # . # # # . . . # # # . . . # . . . . . . . . # . # . # . . # . . . # . . . . . . . # # # . . . . . . # . # . . . # # # . . . # . . . # . . # . . # . # . . . . # . . . . . . . . . . . . #
. # . . . . . . . # # . . . . . . . # . . . . # . . . . . . . # . . . . # . # # # . . # . . . # # # # # . # # # . . . . # . . . . . . # . . # # # # . . . . . # # # . # . . . . # . # . . . . # . . . . . . . . . . . # . . . . . . . # . # . #
. . # . # . # # . . . . # # . # . # . . # . . . # . . . . # . . # . . . . . . # . . . # . . . . . . # . . # . . . . . . # . . . . # # . . . . . # . . . . . . # # . . . . . . # . . # . . . . # . . . . # . . # # . . . # . # # # . . . . . . #
. . . . # . # . # # # # . # . # . . . . # . . # # # . # . # . # # . # . . # . . . . . . . . # # # . . . # # . # # # . . # . # # . # # . # . # # # . . . . # # . . . # . . # . # # . . . . . # . . # . # # # . . . # # . . # # # . . . # . # . .
. . . . # . # . # # # # . # . # . . . . . # # . . . . # # # . . # . . # . # # . . # # . . # . # # # # # # . # . . # # . . # # # . . # . . . # . . # . . # # # # . # # . . . . # # # . . # . . # . # # . . # # . . # . # # # # # # . # . . # # .
. . # . # . # # . . . . # # . # . # . . # . . . . . . # . . # . . . . . . # . . . . . . # . . . . # # . . . . # . . . . # # . . # # . # . . . . . . # . # . . . # . . . . . . # . . # . . . . . . # . . . . . . # . . . . # # . . . . # . . . .
. # . . . . . . . # # . . . . . . . # . # . . . . . # # # # # # . # . . . . # . . # . . . . # . . # # . . # . . . . # . . . . . . . . . . . . # . . # . . # # # # . . . . . # # # # # # . # . . . . # . . # . . . . # . . # # . . # . . . . # .
# # . . . # . . . . . . . . # . . . # # # . # . . . . . . # . . . # # # . . . # . . . # # . . . . # # . . . . # # . . . . . . . . . # # # # . # . # . . . . . # # . # . . . . . . # . . . # # # . . . # . . . # # . . . . # # . . . . # # . . .
. . . . . . . . . # # . . . . . . . . . # . . . . . . . . . . # . . . . . . . . . . . # . . # . . . . . . # . . # . . . . # . # . . . . . # # # . . . # . . . # # . . . . . . . . . . # . . . . . . . . . . . # . . # . . . . . . # . . # . . .
# . . . . . . . . # # . . . . . . . . # . . # . . . # # . . # . . . . . . . . . . # # . # # # # # . . # # # # # . # # . . . . . . . . . . . . # . . . . . . . # . . # . . . # # . . # . . . . . . . . . . # # . # # # # # . . # # # # # . # # .
. . # . . . . . # # # # . . . . . # . . # . . . . . . . . . . # . . . . # . . . . . . . . . . . . # # . . . . . . . . . # . . # . . . . . . # . . # . . # . . . # . . . . . . . . . . # . . . . # . . . . . . . . . . . . # # . . . . . . . . .
. . . . . # . . . # # . . . # . . . . . . . . . . . . . . # . . . . . . . # . . . . . . . # . # . # # . # . # . . . . . # # . . . . # # # . . . . . # . . . . # . . . . . . . . . # . . . . . . . # . . . . . . . # . # . # # . # . # . . . . .
. . . # . . . . . . . . . . . . # . . . . . # . . . . . # . # . . # # . . . # . # # # . . . . . . # # . . . . . . # # # . . . . . . # . . . . . . . # . . . . # . . # . . . . . # . # . . # # . . . # . # # # . . . . . . # # . . . . . . # # #
# # # . # # # . . # # . . # # # . # # # . # . # # # . # . . # # . . . # # . . # # # . . . # . # . . . . # . # . . . # # . . # # . . . . . # # . # . . # . . . . . # . # # # . # . . # # . . . # # . . # # # . . . # . # . . . . # . # . . . # #
# . # . . # . . . . # # # . # # # . # # # . . # # . . . # # . # . # # . # # . # # # . . . . # # . . . # # # . . . . . . . . # . # # # . # . # # . . . # # . . # # # # # . . # . . # . . # . . # . # # . . # # . . # . # # # # # # . # . . # # .
. . . . # . . . . # . . . . . . . . . . . # . . . # # . . # . . . # # . . . . # . . . . . . # . . . . . . . . . # . . . . # . . . . . # . . # . . # # . . . # . . . . # . # . . . . # . . . . . . # . . . . . . # . . . . # # . . . . # . . . .
. . . . # . . . . # # . # # . . . . # # . . # . . . . . . . . . # . . . . . . # . . . # . # . . # . # # # . . . # . . # # . . . . . . . . . . . . . . . . # . . # # # . . # . . # . # # . # . . . . # . . # . . . . # . . # # . . # . . . . # .
# . . # . . # . . . . # # . # # . # . # . . . # . . . . # . # # . . . . . . . # . . . . . . # . . . # . . . . . . . . # . . . . . . . . . # . # . . . . # . . . # . . . . . # . # . . . . # # # . . . # . . . # # . . . . # # . . . . # # . . .
. # . . . . . . . # . . . . # # . . . . . . . . . . . . . # # # . # . . . . . # . . . . . . . . . # # . . # . . . . . # . . # # . . . # . . # . . . . . . . . . # . . . # . . . # # . # . . . . . . . . . . . # . . # . . . . . . # . . # . . .
# # . . . # . . . # . # . . . . . . . . . . . . . . . . # . # . . . . . # . . # # . . . . . # . . . # . . . . . # . # # . . . . . . . . . # . # . . . . . . . . # . . . . . . . # . # . . . . . . . . . . # # . # # # # # . . # # # # # . # # .
. # . # . . . . . # . . . # . . # . # # # . . . # # # . . . # . . . . . . . . # . # . # . . # . . . # . . . . . . . # # # . . . . . . # . # . . . # # # . . . # . . . # . . # . . # . # . . . . # . . . . . . . . . . . . # # . . . . . . . . .
. # . . # . . # # # . . . # . . . . . . . # . . . . # . # # # . . # . . . # # # # # . # # # . . . . # . . . . . . # . . # # # # . . . . . # # # . # . . . . # . # . . . . # . . . . . . . . . . . # . . . . . . . # . # . # # . # . # . . . . .
. . . . # . # . . . # . . . # . . . . # . . # . . . . . . # . . . # . . . . . . # . . # . . . . . . # . . . . # # . . . . . # . . . . . . # # . . . . . . # . . # . . . . # . . . . # . . # # . . . # . # # # . . . . . . # # . . . . . . # # #
# . . # . . # # # # # . . # # # . # . # . # # . # . . # . . . . . . . . # # # . . . # # . # # # . . # . # # . # # . # . # # # . . . . # # . . . # . . # . # # . . . . . # . . # . # # # . . . # # . . # # # . . . # . # . . . . # . # . . . # #
. # # . # . . # . . . . # # # . # # . . # . # # . # # . # . # . # . # # # . . # # . # . # # # . . # # . # . # # # . . # # . # . # # # . . # # . # . # # # . . # # . # . # # # . . # # . # . # # # . . # # . # . # # # . . # # . # . # # # . . #
. . # . . . . . . # . . . . . . # . . # # . . . . # # . . . # . . . . # . . . # # . . . . # . . . # # . . . . # . . . # # . . . . # . . . # # . . . . # . . . # # . . . . # . . . # # . . . . # . . . # # . . . . # . . . # # . . . . # . . . #
. # . . . . # . # # . . . . # # # . # # # . . . . . . # . . . . . . . . # . . . . . . . . . # . . . . . . . . . # . . . . . . . . . # . . . . . . . . . # . . . . . . . . . # . . . . . . . . . # . . . . . . . . . # . . . . . . . . . # . . .
# . . . # # # . . . . . . # . . # . # . # . . . . . . . # # # # . # . . # . . . # # . # . . # . . . # # . # . . # . . . # # . # . . # . . . # # . # . . # . . . # # . # . . # . . . # # . # . . # . . . # # . # . . # . . . # # . # . . # . . .
. . . . . . . . # . . . . # . . . . . # # . . . . . # . # # . . . . . . . . # . . . . . . . . . # . . . . . . . . . # . . . . . . . . . # . . . . . . . . . # . . . . . . . . . # . . . . . . . . . # . . . . . . . . . # . . . . . . . . . # .
. . . . . . . . . # # . . . . . . . . . # . . # . . . . . # . . . . # # . . . . . . . . # # . . . . . . . . # # . . . . . . . . # # . . . . . . . . # # . . . . . . . . # # . . . . . . . . # # . . . . . . . . # # . . . . . . . . # # . . . .
. . . # . . . . # . . . . # . . . . . . # . . . . . . . . # # . # . # # . # # . # . # . # # . # # . # . # . # # . # # . # . # . # # . # # . # . # . # # . # # . # . # . # # . # # . # . # . # # . # # . # . # . # # . # # . # . # . # # . # # .
. . # . . . . . . . . # . . # . # . . . # # # . . . # . . # # # . . . . # # . # # # . . . . # # . # # # . . . . # # . # # # . . . . # # . # # # . . . . # # . # # # . . . . # # . # # # . . . . # # . # # # . . . . # # . # # # . . . . # # . #
. # . . . # # . . # . . . # . . . . . . . . . . . . # . . . . . . . . . . . . . . . . . . . . . . . . . . . . . . . . . . . . . . . . . . . . . . . . . . . . . . . . . . . . . . . . . . . . . . . . . . . . . . . . . . . . . . . . . . . . .
# . . # # . . . # # . . # # . . . . # # . # # # . . . . . . # # . # # # . # # # # # . # # # . # # # # # . # # # . # # # # # . # # # . # # # # # . # # # . # # # # # . # # # . # # # # # . # # # . # # # # # . # # # . # # # # # . # # # . # # #
. # # . . . . # # # . . # . . # . # # . . # # . . # . # # # # # # . # . . # # . . # # # . . # . . . # . . # . . # # # # . # # . . . . # # # . . # . . # . # # . . # # . . # . # # # # # # . # . . # # . . # # # . . # . . . # . . # . . # # # #
# . . . . . . # . . # . . . . . . # . . . . . . # . . . . # # . . . . # . . . . # # . . # # . # . . . . . . # . # . . . # . . . . . . # . . # . . . . . . # . . . . . . # . . . . # # . . . . # . . . . # # . . # # . # . . . . . . # . # . . .
# . . . . . # # # # # # . # . . . . # . . # . . . . # . . # # . . # . . . . # . . . . . . . . . . . . # . . # . . # # # # . . . . . # # # # # # . # . . . . # . . # . . . . # . . # # . . # . . . . # . . . . . . . . . . . . # . . # . . # # #
# . # . . . . . . # . . . # # # . . . # . . . # # . . . . # # . . . . # # . . . . . . . . . # # # # . # . # . . . . . # # . # . . . . . . # . . . # # # . . . # . . . # # . . . . # # . . . . # # . . . . . . . . . # # # # . # . # . . . . . #
# . . . . . . . . . . # . . . . . . . . . . . # . . # . . . . . . # . . # . . . . # . # . . . . . # # # . . . # . . . # # . . . . . . . . . . # . . . . . . . . . . . # . . # . . . . . . # . . # . . . . # . # . . . . . # # # . . . # . . . #
. . # . . . # # . . # . . . . . . . . . . # # . # # # # # . . # # # # # . # # . . . . . . . . . . . . # . . . . . . . # . . # . . . # # . . # . . . . . . . . . . # # . # # # # # . . # # # # # . # # . . . . . . . . . . . . # . . . . . . . #
# . . . . . . . . . . # . . . . # . . . . . . . . . . . . # # . . . . . . . . . # . . # . . . . . . # . . # . . # . . . # . . . . . . . . . . # . . . . # . . . . . . . . . . . . # # . . . . . . . . . # . . # . . . . . . # . . # . . # . . .
. . . . . . . . . # . . . . . . . # . . . . . . . # . # . # # . # . # . . . . . # # . . . . # # # . . . . . # . . . . # . . . . . . . . . # . . . . . . . # . . . . . . . # . # . # # . # . # . . . . . # # . . . . # # # . . . . . # . . . . #
. . # . . . . . # . # . . # # . . . # . # # # . . . . . . # # . . . . . . # # # . . . . . . # . . . . . . . # . . . . # . . # . . . . . # . # . . # # . . . # . # # # . . . . . . # # . . . . . . # # # . . . . . . # . . . . . . . # . . . . #
. # . # # # . # . . # # . . . # # . . # # # . . . # . # . . . . # . # . . . # # . . # # . . . . . # # . # . . # . . . . . # . # # # . # . . # # . . . # # . . # # # . . . # . # . . . . # . # . . . # # . . # # . . . . . # # . # . . # . . . .
# # # . # # # . # # # . . # # . . . # # . # . # # . # # . # # # . . . . # # . . . # # # . . . . . . . . # . # # # . # . # # . . . # # . . # # # # # . . # . . # . . # . . # . # # . . # # . . # . # # # # # # . # . . # # . . # # # . . # . . .
. . . . . . . . . . . # . . . # # . . # . . . # # . . . . # . . . . . . # . . . . . . . . . # . . . . # . . . . . # . . # . . # # . . . # . . . . # . # . . . . # . . . . . . # . . . . . . # . . . . # # . . . . # . . . . # # . . # # . # . .
# . # # . . . . # # . . # . . . . . . . . . # . . . . . . # . . . # . # . . # . # # # . . . # . . # # . . . . . . . . . . . . . . . . # . . # # # . . # . . # . # # . # . . . . # . . # . . . . # . . # # . . # . . . . # . . . . . . . . . . .
. # # . # # . # . # . . . # . . . . # . # # . . . . . . . # . . . . . . # . . . # . . . . . . . . # . . . . . . . . . # . # . . . . # . . . # . . . . . # . # . . . . # # # . . . # . . . # # . . . . # # . . . . # # . . . . . . . . . # # # #
. . . . # # . . . . . . . . . . . . . # # # . # . . . . . # . . . . . . . . . # # . . # . . . . . # . . # # . . . # . . # . . . . . . . . . # . . . # . . . # # . # . . . . . . . . . . . # . . # . . . . . . # . . # . . . . # . # . . . . . #
. # . . . . . . . . . . . . . . . . # . # . . . . . # . . # # . . . . . # . . . # . . . . . # . # # . . . . . . . . . # . # . . . . . . . . # . . . . . . . # . # . . . . . . . . . . # # . # # # # # . . # # # # # . # # . . . . . . . . . . .
. . . # . . # . # # # . . . # # # . . . # . . . . . . . . # . # . # . . # . . . # . . . . . . . # # # . . . . . . # . # . . . # # # . . . # . . . # . . # . . # . # . . . . # . . . . . . . . . . . . # # . . . . . . . . . # . . # . . . . . .
. . . # . . . . . . . # . . . . # . # # # . . # . . . # # # # # . # # # . . . . # . . . . . . # . . # # # # . . . . . # # # . # . . . . # . # . . . . # . . . . . . . . . . . # . . . . . . . # . # . # # . # . # . . . . . # # . . . . # # # .
# . . . # . . . . # . . # . . . . . . # . . . # . . . . . . # . . # . . . . . . # . . . . # # . . . . . # . . . . . . # # . . . . . . # . . # . . . . # . . . . # . . # # . . . # . # # # . . . . . . # # . . . . . . # # # . . . . . . # . . .
# . . # # # . # . # . # # . # . . # . . . . . . . . # # # . . . # # . # # # . . # . # # . # # . # . # # # . . . . # # . . . # . . # . # # . . . . . # . . # . # # # . . . # # . . # # # . . . # . # . . . . # . # . . . # # . . # # . . . . . #
# # . . . # . # . . # . . # . . # # # # . # # . . . . # # # . . # . . # . # # . . # # . . # . # # # # # # . # . . # # . . # # # . . # . . . # . . # . . # # # # . # # . . . . # # # . . # . . # . # # . . # # . . # . # # # # # # . # . . # # .
# # # . . . . . . # . . . . # . # . . . # . . . . . . # . . # . . . . . . # . . . . . . # . . . . # # . . . . # . . . . # # . . # # . # . . . . . . # . # . . . # . . . . . . # . . # . . . . . . # . . . . . . # . . . . # # . . . . # . . . .
. . . . . # . # . # . # . . # . . # # # # . . . . . # # # # # # . # . . . . # . . # . . . . # . . # # . . # . . . . # . . . . . . . . . . . . # . . # . . # # # # . . . . . # # # # # # . # . . . . # . . # . . . . # . . # # . . # . . . . # .
. . . . . . . . . # . # . # . . . . . # # . # . . . . . . # . . . # # # . . . # . . . # # . . . . # # . . . . # # . . . . . . . . . # # # # . # . # . . . . . # # . # . . . . . . # . . . # # # . . . # . . . # # . . . . # # . . . . # # . . .
. # # . # # # # # . # # . . . # . . . # # . . . . . . . . . . # . . . . . . . . . . . # . . # . . . . . . # . . # . . . . # . # . . . . . # # # . . . # . . . # # . . . . . . . . . . # . . . . . . . . . . . # . . # . . . . . . # . . # . . .
. . . # . . # . . . . # . . . . . . . # . . # . . . # # . . # . . . . . . . . . . # # . # # # # # . . # # # # # . # # . . . . . . . . . . . . # . . . . . . . # . . # . . . # # . . # . . . . . . . . . . # # . # # # # # . . # # # # # . # # .
. . . # # . . . . # # . . # . . # . . . # . . . . . . . . . . # . . . . # . . . . . . . . . . . . # # . . . . . . . . . # . . # . . . . . . # . . # . . # . . . # . . . . . . . . . . # . . . . # . . . . . . . . . . . . # # . . . . . . . . .
. # . . . . # . . # . . . . # . . . . # . . . . . . . . . # . . . . . . . # . . . . . . . # . # . # # . # . # . . . . . # # . . . . # # # . . . . . # . . . . # . . . . . . . . . # . . . . . . . # . . . . . . . # . # . # # . # . # . . . . .
. . . . # . . . . # . . . . # . . . . # . . # . . . . . # . # . . # # . . . # . # # # . . . . . . # # . . . . . . # # # . . . . . . # . . . . . . . # . . . . # . . # . . . . . # . # . . # # . . . # . # # # . . . . . . # # . . . . . . # # #
. # # . . # . # # # # . # . . # . . . . . # . # # # . # . . # # . . . # # . . # # # . . . # . # . . . . # . # . . . # # . . # # . . . . . # # . # . . # . . . . . # . # # # . # . . # # . . . # # . . # # # . . . # . # . . . . # . # . . . # #
# . # . # # # . . # # . # . # # # . . # # . # . # # # . . # # . # . # # # . . # # . # . # # # . . # # . # . # # # . . # # . # . # # # . . # # . # . # # # . . # # . # . # # # . . # # . # . # # # . . # # . # . # # # . . # # . # . # # # . . #
# . . . . # . . . # # . . . . # . . . # # . . . . # . . . # # . . . . # . . . # # . . . . # . . . # # . . . . # . . . # # . . . . # . . . # # . . . . # . . . # # . . . . # . . . # # . . . . # . . . # # . . . . # . . . # # . . . . # . . . #
. . . . . . # . . . . . . . . . # . . . . . . . . . # . . . . . . . . . # . . . . . . . . . # . . . . . . . . . # . . . . . . . . . # . . . . . . . . . # . . . . . . . . . # . . . . . . . . . # . . . . . . . . . # . . . . . . . . . # . . .
# # . # . . # . . . # # . # . . # . . . # # . # . . # . . . # # . # . . # . . . # # . # . . # . . . # # . # . . # . . . # # . # . . # . . . # # . # . . # . . . # # . # . . # . . . # # . # . . # . . . # # . # . . # . . . # # . # . . # . . .
. . . . . . . . # . . . . . . . . . # . . . . . . . . . # . . . . . . . . . # . . . . . . . . . # . . . . . . . . . # . . . . . . . . . # . . . . . . . . . # . . . . . . . . . # . . . . . . . . . # . . . . . . . . . # . . . . . . . . . # .
. . . . # # . . . . . . . . # # . . . . . . . . # # . . . . . . . . # # . . . . . . . . # # . . . . . . . . # # . . . . . . . . # # . . . . . . . . # # . . . . . . . . # # . . . . . . . . # # . . . . . . . . # # . . . . . . . . # # . . . .
# . # . # # . # # . # . # . # # . # # . # . # . # # . # # . # . # . # # . # # . # . # . # # . # # . # . # . # # . # # . # . # . # # . # # . # . # . # # . # # . # . # . # # . # # . # . # . # # . # # . # . # . # # . # # . # . # . # # . # # .
# # . . . . # # . # # # . . . . # # . # # # . . . . # # . # # # . . . . # # . # # # . . . . # # . # # # . . . . # # . # # # . . . . # # . # # # . . . . # # . # # # . . . . # # . # # # . . . . # # . # # # . . . . # # . # # # . . . . # # . #
. . . . . . . . . . . . . . . . . . . . . . . . . . . . . . . . . . . . . . . . . . . . . . . . . . . . . . . . . . . . . . . . . . . . . . . . . . . . . . . . . . . . . . . . . . . . . . . . . . . . . . . . . . . . . . . . . . . . . . . .
# # . # # # . # # # # # . # # # . # # # # # . # # # . # # # # # . # # # . # # # # # . # # # . # # # # # . # # # . # # # # # . # # # . # # # # # . # # # . # # # # # . # # # . # # # # # . # # # . # # # # # . # # # . # # # # # . # # # . # # #
. # # . . . . # # # . . # . . # . # # . . # # . . # . # # # # # # . # . . # # . . # # # . . # . . . # . . # . . # # # # . # # . . . . # # # . . # . . # . # # . . # # . . # . # # # # # # . # . . # # . . # # # . . # . . . # . . # . . # # # #
# . . . . . . # . . # . . . . . . # . . . . . . # . . . . # # . . . . # . . . . # # . . # # . # . . . . . . # . # . . . # . . . . . . # . . # . . . . . . # . . . . . . # . . . . # # . . . . # . . . . # # . . # # . # . . . . . . # . # . . .
# . . . . . # # # # # # . # . . . . # . . # . . . . # . . # # . . # . . . . # . . . . . . . . . . . . # . . # . . # # # # . . . . . # # # # # # . # . . . . # . . # . . . . # . . # # . . # . . . . # . . . . . . . . . . . . # . . # . . # # #
# . # . . . . . . # . . . # # # . . . # . . . # # . . . . # # . . . . # # . . . . . . . . . # # # # . # . # . . . . . # # . # . . . . . . # . . . # # # . . . # . . . # # . . . . # # . . . . # # . . . . . . . . . # # # # . # . # . . . . . #
# . . . . . . . . . . # . . . . . . . . . . . # . . # . . . . . . # . . # . . . . # . # . . . . . # # # . . . # . . . # # . . . . . . . . . . # . . . . . . . . . . . # . . # . . . . . . # . . # . . . . # . # . . . . . # # # . . . # . . . #
. . # . . . # # . . # . . . . . . . . . . # # . # # # # # . . # # # # # . # # . . . . . . . . . . . . # . . . . . . . # . . # . . . # # . . # . . . . . . . . . . # # . # # # # # . . # # # # # . # # . . . . . . . . . . . . # . . . . . . . #
# . . . . . . . . . . # . . . . # . . . . . . . . . . . . # # . . . . . . . . . # . . # . . . . . . # . . # . . # . . . # . . . . . . . . . . # . . . . # . . . . . . . . . . . . # # . . . . . . . . . # . . # . . . . . . # . . # . . # . . .
. . . . . . . . . # . . . . . . . # . . . . . . . # . # . # # . # . # . . . . . # # . . . . # # # . . . . . # . . . . # . . . . . . . . . # . . . . . . . # . . . . . . . # . # . # # . # . # . . . . . # # . . . . # # # . . . . . # . . . . #
. . # . . . . . # . # . . # # . . . # . # # # . . . . . . # # . . . . . . # # # . . . . . . # . . . . . . . # . . . . # . . # . . . . . # . # . . # # . . . # . # # # . . . . . . # # . . . . . . # # # . . . . . . # . . . . . . . # . . . . #
. # . # # # . # . . # # . . . # # . . # # # . . . # . # . . . . # . # . . . # # . . # # . . . . . # # . # . . # . . . . . # . # # # . # . . # # . . . # # . . # # # . . . # . # . . . . # . # . . . # # . . # # . . . . . # # . # . . # . . . .
# # # . # # # . # # # . . # # . . . # # . # . # # . # # . # # # . . . . # # . . . # # # . . . . . . . . # . # # # . # . # # . . . # # . . # # # # # . . # . . # . . # . . # . # # . . # # . . # . # # # # # # . # . . # # . . # # # . . # . . .
. . . . . . . . . . . # . . . # # . . # . . . # # . . . . # . . . . . . # . . . . . . . . . # . . . . # . . . . . # . . # . . # # . . . # . . . . # . # . . . . # . . . . . . # . . . . . . # . . . . # # . . . . # . . . . # # . . # # . # . .
# . # # . . . . # # . . # . . . . . . . . . # . . . . . . # . . . # . # . . # . # # # . . . # . . # # . . . . . . . . . . . . . . . . # . . # # # . . # . . # . # # . # . . . . # . . # . . . . # . . # # . . # . . . . # . . . . . . . . . . .
. # # . # # . # . # . . . # . . . . # . # # . . . . . . . # . . . . . . # . . . # . . . . . . . . # . . . . . . . . . # . # . . . . # . . . # . . . . . # . # . . . . # # # . . . # . . . # # . . . . # # . . . . # # . . . . . . . . . # # # #
. . . . # # . . . . . . . . . . . . . # # # . # . . . . . # . . . . . . . . . # # . . # . . . . . # . . # # . . . # . . # . . . . . . . . . # . . . # . . . # # . # . . . . . . . . . . . # . . # . . . . . . # . . # . . . . # . # . . . . . #
. # . . . . . . . . . . . . . . . . # . # . . . . . # . . # # . . . . . # . . . # . . . . . # . # # . . . . . . . . . # . # . . . . . . . . # . . . . . . . # . # . . . . . . . . . . # # . # # # # # . . # # # # # . # # . . . . . . . . . . .
. . . # . . # . # # # . . . # # # . . . # . . . . . . . . # . # . # . . # . . . # . . . . . . . # # # . . . . . . # . # . . . # # # . . . # . . . # . . # . . # . # . . . . # . . . . . . . . . . . . # # . . . . . . . . . # . . # . . . . . .
. . . # . . . . . . . # . . . . # . # # # . . # . . . # # # # # . # # # . . . . # . . . . . . # . . # # # # . . . . . # # # . # . . . . # . # . . . . # . . . . . . . . . . . # . . . . . . . # . # . # # . # . # . . . . . # # . . . . # # # .
# . . . # . . . . # . . # . . . . . . # . . . # . . . . . . # . . # . . . . . . # . . . . # # . . . . . # . . . . . . # # . . . . . . # . . # . . . . # . . . . # . . # # . . . # . # # # . . . . . . # # . . . . . . # # # . . . . . . # . . .
# . . # # # . # . # . # # . # . . # . . . . . . . . # # # . . . # # . # # # . . # . # # . # # . # . # # # . . . . # # . . . # . . # . # # . . . . . # . . # . # # # . . . # # . . # # # . . . # . # . . . . # . # . . . # # . . # # . . . . . #
# # . . . # . # . . # . . # . . # # # # . # # . . . . # # # . . # . . # . # # . . # # . . # . # # # # # # . # . . # # . . # # # . . # . . . # . . # . . # # # # . # # . . . . # # # . . # . . # . # # . . # # . . # . # # # # # # . # . . # # .
# # # . . . . . . # . . . . # . # . . . # . . . . . . # . . # . . . . . . # . . . . . . # . . . . # # . . . . # . . . . # # . . # # . # . . . . . . # . # . . . # . . . . . . # . . # . . . . . . # . . . . . . # . . . . # # . . . . # . . . .
. . . . . # . # . # . # . . # . . # # # # . . . . . # # # # # # . # . . . . # . . # . . . . # . . # # . . # . . . . # . . . . . . . . . . . . # . . # . . # # # # . . . . . # # # # # # . # . . . . # . . # . . . . # . . # # . . # . . . . # .
. . . . . . . . . # . # . # . . . . . # # . # . . . . . . # . . . # # # . . . # . . . # # . . . . # # . . . . # # . . . . . . . . . # # # # . # . # . . . . . # # . # . . . . . . # . . . # # # . . . # . . . # # . . . . # # . . . . # # . . .
. # # . # # # # # . # # . . . # . . . # # . . . . . . . . . . # . . . . . . . . . . . # . . # . . . . . . # . . # . . . . # . # . . . . . # # # . . . # . . . # # . . . . . . . . . . # . . . . . . . . . . . # . . # . . . . . . # . . # . . .
. . . # . . # . . . . # . . . . . . . # . . # . . . # # . . # . . . . . . . . . . # # . # # # # # . . # # # # # . # # . . . . . . . . . . . . # . . . . . . . # . . # . . . # # . . # . . . . . . . . . . # # . # # # # # . . # # # # # . # # .
. . . # # . . . . # # . . # . . # . . . # . . . . . . . . . . # . . . . # . . . . . . . . . . . . # # . . . . . . . . . # . . # . . . . . . # . . # . . # . . . # . . . . . . . . . . # . . . . # . . . . . . . . . . . . # # . . . . . . . . .
. # . . . . # . . # . . . . # . . . . # . . . . . . . . . # . . . . . . . # . . . . . . . # . # . # # . # . # . . . . . # # . . . . # # # . . . . . # . . . . # . . . . . . . . . # . . . . . . . # . . . . . . . # . # . # # . # . # . . . . .
. . . . # . . . . # . . . . # . . . . # . . # . . . . . # . # . . # # . . . # . # # # . . . . . . # # . . . . . . # # # . . . . . . # . . . . . . . # . . . . # . . # . . . . . # . # . . # # . . . # . # # # . . . . . . # # . . . . . . # # #
. # # . . # . # # # # . # . . # . . . . . # . # # # . # . . # # . . . # # . . # # # . . . # . # . . . . # . # . . . # # . . # # . . . . . # # . # . . # . . . . . # . # # # . # . . # # . . . # # . . # # # . . . # . # . . . . # . # . . . # #
# . # . # # # . . # # . # . # # # . . # # . # . # # # . . # # . # . # # # . . # # . # . # # # . . # # . # . # # # . . # # . # . # # # . . # # . # . # # # . . # # . # . # # # . . # # . # . # # # . . # # . # . # # # . . # # . # . # # # . . #
# . . . . # . . . # # . . . . # . . . # # . . . . # . . . # # . . . . # . . . # # . . . . # . . . # # . . . . # . . . # # . . . . # . . . # # . . . . # . . . # # . . . . # . . . # # . . . . # . . . # # . . . . # . . . # # . . . . # . . . #
. . . . . . # . . . . . . . . . # . . . . . . . . . # . . . . . . . . . # . . . . . . . . . # . . . . . . . . . # . . . . . . . . . # . . . . . . . . . # . . . . . . . . . # . . . . . . . . . # . . . . . . . . . # . . . . . . . . . # . . .
# # . # . . # . . . # # . # . . # . . . # # . # . . # . . . # # . # . . # . . . # # . # . . # . . . # # . # . . # . . . # # . # . . # . . . # # . # . . # . . . # # . # . . # . . . # # . # . . # . . . # # . # . . # . . . # # . # . . # . . .
. . . . . . . . # . . . . . . . . . # . . . . . . . . . # . . . . . . . . . # . . . . . . . . . # . . . . . . . . . # . . . . . . . . . # . . . . . . . . . # . . . . . . . . . # . . . . . . . . . # . . . . . . . . . # . . . . . . . . . # .
. . . . # # . . . . . . . . # # . . . . . . . . # # . . . . . . . . # # . . . . . . . . # # . . . . . . . . # # . . . . . . . . # # . . . . . . . . # # . . . . . . . . # # . . . . . . . . # # . . . . . . . . # # . . . . . . . . # # . . . .
# . # . # # . # # . # . # . # # . # # . # . # . # # . # # . # . # . # # . # # . # . # . # # . # # . # . # . # # . # # . # . # . # # . # # . # . # . # # . # # . # . # . # # . # # . # . # . # # . # # . # . # . # # . # # . # . # . # # . # # .
# # . . . . # # . # # # . . . . # # . # # # . . . . # # . # # # . . . . # # . # # # . . . . # # . # # # . . . . # # . # # # . . . . # # . # # # . . . . # # . # # # . . . . # # . # # # . . . . # # . # # # . . . . # # . # # # . . . . # # . #
. . . . . . . . . . . . . . . . . . . . . . . . . . . . . . . . . . . . . . . . . . . . . . . . . . . . . . . . . . . . . . . . . . . . . . . . . . . . . . . . . . . . . . . . . . . . . . . . . . . . . . . . . . . . . . . . . . . . . . . .
# # . # # # . # # # # # . # # # . # # # # # . # # # . # # # # # . # # # . # # # # # . # # # . # # # # # . # # # . # # # # # . # # # . # # # # # . # # # . # # # # # . # # # . # # # # # . # # # . # # # # # . # # # . # # # # # . # # # . # # #
