.##.#.#.#....#....#...........#....#.#...........#.#.#.#................#..##.#..#.#............
.......#.....#.....#......##.#......#..........#...#...#.#..##.##..#............#...#...#......#
...#...#.......####..#.##..#..##..##...#.......#..##...#.......#..#..#.......###..##.....#......
............###...###.#..#####.##...#......#..#..#..#..#..#...##.......##.#..........#.#........
........#....#...#..#......#....#......####..#.###..###....#.......#.#.#.............#...##.....
#.....#..##.#....##.........#....##...#..#........#.##..####.#..#.....#...#......#...#....#.....
...#.........#.#.......#...###......#............##..##.........##......#....###.#...#..........
.....#...#..#.#.....#.#.#.#...#..#.........#.........##.###.#.#........#.....#.....#...#..#...#.
.#....#......#......#.........#.##..#####...##..#.#.............#......#..#......#..............
.......#...#..#....#....#...............##..#..#....#...#..........#.#........#......#...##.....
...#...........#.......##....#............#...#....#......###......#..#......#........#.......#.
.......#....#..##....#.#.#.......#...#....#..####.##.###.#..#.###...#..#...##.....##...#........
#.#..#.........#...............##..###.#.....###....##....##........#...................#.......
....#.#....#......####.............##..#...#..#....#....##.........#.#............#...#..#..#...
...###....##....##....#..#..#....##.........#...##......##.#.............##...............#....#
#...#.#..##.#..#..#..#.......#.#.....#....#.##..#......#......#...............#......#...#...#..
.......#..#................##.#...#.........##............#......#..#...........#...#...........
#.......##.............#.....#.#...###........#.......#.......#......................#......#.#.
#.#..............#...#....##.......#...#.......#..#.#.......#...#......#.......#..#..##....#....
........#.......#..#......#....#......#......#.#.#....#..#...#.......#...##.......#..........#..
...#.#...........#.......#..#..#....#.....#........#.........#..#......##....#...#..#.##.....###
....#...###...#.....#.#.........#....#............##..#...##.....##.#..#............#.#.#.......
.....#......#.....#.......#.....#.##.#..##...#.....##..##.............#.....#.##........#.......
..............#......#....#..#.....##..#.....#..#.#....#......#...#.#......##.............#...#.
.......#.....##....####..##..##..............#..#####......#..#..#..#..#..#....#.....#.........#
......#.....#.............##..#....#...#....#......##..####.#..##....##...##................#...
.....#..#..##..#..#..#..#..#.#.....#..............#...#..###..#.......#.......#...#......#.#....
..#.#....###..#.##....###...#.................#....#....##....#....#.....................#.....#
#.........#..#.#....#......#..#..#...#....#...........#.............#.....#...#......#..#..###..
.....#...#.#...#..#....#.........#...##.#.#........##...#.................#....................#
........#.............#....#.#...........##..........#...##.##..##.#.#.#......#...#..###........
..........#....#......#..#.##..#......#....#............##....##....#...#....#......#...........
.#......##.#.......................##.......#....#....##.....#..#..##....#..........#.....##....
.#...#...##.....#......#......##.........#..............#.##.#....#.##.......................#..
........####..##......#...#...#.#........###....#....#...###..#.##....#......#..#..#.......#.#..
.....#...###..#...............#..#...#.#............#......#.........#.#.#..#.#.......##........
..#.....#......###..#..##.#.......................####.##...#.##..............##........#.....#.
....#......#....##...##....#........#......##.#....###.#..##...#........#........#...#..........
#.......#..#.....#.#........#....#.#..........#.......#..#..#.##.#......#.##.#............#.....
.....#.#..#.....#..#...#.....#..#...##.......#......#.........#............#.........#..........
.#..#..#.....#...#..#.........#.......#.........##.##..#..#...#...###..........##...##..........
......................#...........#...#........####..###..##.#...........#...#...#......#...##..
...##........#....##.....#...#...#..#....###............#.##..#.#........#........#....#....#.#.
............#.....#.#.##...........#.#...........#..##.#.......#.#...#.......#.#............#...
........#.....#.......................#.......#.#...#.........##...#..##.....#.........#......#.
#......#.#....#.#......#...#..#.......##.#..#..#..#.......#...#..#...##.#.#........###..........
............#......##..###.#.#......#...###...###.#..........#.##..........#.#..#....#.#.#......
..........#.....###..#.#..#...#...#.#..##..##.##.........##.....###..........#.#.#..........#...
......#.##...###....#....###..#....##.#.##..#..#.......###...#..#.#..........#......#.#.######.#
.......##...#.##.....#..#...#.#.###....##..#####...##..#.............#..#........#..#.#........#
...#.....#.....##.#..#..........##.....##..#..#........#...............#....#...#...##.........#
..#......##...##.......#....#................##..###.#.....#..............#....#.....#..#...#...
.#...#.....#..#....##....##...#........#..............##.#.#....#...##.........#....#.......#...
#..........###...#.##.##..#..#..#............#........#......#....#..#...#.##...................
...#.#.#.#....#.#....##....##.#..#..............#..#...##..........#.#......#..#...............#
#.........#...#..................##.#.....#.#....##...##......#...#........#.##..#.#.##.##......
.....#.#.#.....#..#.##..#..#..#...#..#....#..#..##...#.......#....#..#......##..........#....#..
.##.#.###..####.#..##....##....##...#...#....#..#..........#....#..........#..#...#.#..#...#.#.#
.............#.....#.#.........##.#.....#........#.................#..........#............#...#
..#...#............#......#..#.......#....#......#....#.#......#....#...........................
#.#...#.........#......##.#..##.#...#...#..##.......#.#....#.#.##...........#...................
#..#.....#..#.##..#..#..#...#........#...........#.#......#.#.#.#...#............#..#....#.....#
...#....#....##....##...##........#......#..#..#......#........#..........##....##..#...........
.........#......#.#.................#..#.#.......#..#.........#...#...#..........#.....#........
#...#.....#...#....#.....#........#.....#....#....#..##........#.###..#.#.....#.#..##...........
................#...#.#..#....##.#.....#..#..##....##......#........#.##.#..##............#.....
#........#....#...#.......#...##...#....#.##........#.......#...#..#...........#.....#....#..#..
...#..#......#.#.###....##....####.#.....###...#..#..............#...#..................#...#...
.##..#..#.##...#.##.#.##..##.#..###.#.....#....#.#...#........#.......#.#......#......#.......##
..#..##....#..#............##..........#............###............#.........#....#.............
#..........#...#.##...#..##...#.#.##........#...#...#..........#.......##.#..#.##..##..#........
...................##..#.#....................#.....##....#..#...#....#.##.#..###...#.....#...##
.#..............##.......#...#.....#.............#.....#......#..#......#..#..##.#.##..##.....#.
.##.....#.#...#.....#.#.#............#.....#.#..#...#.#..........#.#.###...###....##.....#......
..#...#...#.....................##.........#.#.........##........#.#..##.#...#.............##.#.
..#.##...###....##.#####...##......#....###....#......#..#...#..#....#.....##...................
.#....#.....#..#..#..#..#..##.....###....##.#..###...##....##.....#.....#.#..##......#......#..#
...#..#....#......##.............#..##..#####.#..#.##..#.#....##.#...#...........#........##.#..
...#..#......#..#....#..#........#..#....###...#.........#...........#........#......##.#..#...#
.#...#...##........#............##....#........#.#.......#.#.#.#.#...#..#.#......#............#.
................#....##....#.#......#####.#.##.......#..#..##...#..#....#.##....#....####..##...
......#..#.#.##..#....#.#....#......#.#.#.......##....#...#............#.........#.#.....##.#...
.##...#..#...#...#......##.#...#........#.#.....#.#..#....#.#.......#...#...#...........#.....#.
..#.............#..................#...#.....#...............###..#..#...#...#.........###......
..........#...................#....#...........#.....#......#...........#.##...........#......##
.#.#.....#..###.......#.#..##.....#...#..#.######........##.##.......#.......#......#....#....#.
..#......#....#....#..........#.#######...##.##.......#................#.....#.#...............#
.#...#.......#...#...#...........#..#.......###...##..#...#....###...#.#.........#........#.....
..#.##........#.#..##...#...##.#.....#..#....#...#..#..#........#.#...#........#.#........#...#.
#..#........##......#........##....###.###..#..#............#....#.#.......#..##........#..#.#.#
..........#.....#..#..#...........#..#.#...........#......#......#.......#....#......#....#.....
..#.##...#..........###.....#.....#..........##..#...#.#.##............#.#.#..##.....#...#......
#.....##...#.............................#.......##..#...#..##.......#.#...........#.......#.#..
.#...##..........#......##........#......#.........#.##.#.......#....#........#.....#......#....
..........#..#.....#...#.#....###..#.#.........#.........#..........#.#.#...#.#.......#....#....
.....#.#.#...#..#.#.....#..#......#.....####..#...........#.#...........#......#....#........##.
