.##.#.#..#..#.#.....#.#.#.#...#..#.........#.........##.###.#.#........#.....#.....#...#........
.......#.....#.#.......#...###......#............##..##.........##......#....###.#...#..#......#
...#...#.##.#....##.........#....##...#..#........#.##..####.#..#.....#...#......#...#...#......
........#....#...#..#......#....#......####..#.###..###....#.......#.#.#.............#..........
............###...###.#..#####.##...#......#..#..#..#..#..#...##.......##.#..........#.#.##.....
#.....#........####..#.##..#..##..##...#.......#..##...#.......#..#..#.......###..##......#.....
...#.........#.....#......##.#......#..........#...#...#.#..##.##..#............#...#...........
.....#..#....#....#...........#....#.#...........#.#.#.#................#..##.#..#.#......#...#.
.#....#......#......#.........#.##..#####...##..#......#......#.#......#..#......#.......#...#..
.......#...#..#....#....#...............##..#..###......##.#.......#.#........#......#....#....#
...#...........#.......##....#............#...#....#....##.........#..#......#........#..#..#...
.......#....#..##....#.#.#.......#...#....#..###....##....##....#...#..#...##.....##...##.......
#.#..#.........#...............##..###.#.....####.##.###.#..#.##....#...........................
....#.#....#......####.............##..#...#..#....#......###......#.#............#...#.......#.
...###....##....##....#..#..#....##.........#.......#...#................##..............##.....
#...#.#..##.#..#..#..#.......#.#.....#....#.##..#.#...........................#......#..........
.......#..#...............#..#.....##..#....##............#......#..#......##...#...#...........
#.......##.............#..#.....#.##.#........#.......#.......#.............#.##.....#......#.#.
#.#..............#...#..........#....#.........#..#.#.......#...#......#..........#..##....#....
........#.......#..#.....#..#..#....#........#.#.#....#..#...#.......#..#....#....#..........#..
...#.#...........#........#....#......#...#........#.........#..#......#.##......#..#.##.....###
....#...###...#.....#.#...##.......#...#..........##..#...##.....##.#..#.......#....#.#.#.......
.....#......#.....#..........#.#...###..##...#.....##..##.............#.................#.......
..............#......#.....##.#...#..........#..#.#....#......#...#.#.....................#...#.
.......#..#....#......#..#.##..#......#......#..#####...##....##....#...#....#.......#.........#
......#.#.............#....#.#..............#......##..#.##.##..##.#.#.#......#.............#...
.....#...#.#...#..#....#.........#...##...........#...#.#.................#.......#......#.#....
..#.#.....#..#.#....#......#..#..#...#........#....#................#.....#...#..........#.....#
#........###..#.##....###...#.............#...........#.##....#....#.................#..#..###..
.....#..#..##..#..#..#..#..#.#.....#....#.#........##....###..#.......#.......#................#
............#.............##..#....#...#.##..........#..###.#..##....##...##......#..###........
.............##....####..##..##............#...............#..#..#..#..#..#....#....#...........
.#......##.#....#..#...#.....#..#...##......#....#....##.....#...........#..........#.....##....
.#...#...##......#.#........#....#.#.....#..............#.##.#...#...........................#..
........####..####...##....#........#....###....#....#...###..#..............#..#..#.......#.#..
.....#...###..#.##..#..##.#.........................#......#.............#..#.#.......##........
..#.....#......#..............#..#...#.#..........####.##...#.##.....#.#......##........#.....#.
....#......#..........#...#...#.#..........##.#....###.#..##...###....#.#........#...#..........
#.......#..#....#......#......##..............#.......#..#..#.##..#.##..#.##.#............#.....
.....#.#..#........................##........#......#.........#.#..##......#.........#..........
.#..#..#..#......#..#.........#.......#..................##.....###............#.#..............
............#.........#...........#...#........##.#..........#.##........#...#..#....#.##...##..
...##....#....#...##.....#...#...#..#....###......#.......#...#..#...##..#.........###......#.#.
........#.....#...#.#.##...........#.#..........#...#.........##...#..##.....#.#.......#....#...
............#.........................#.......#..#..##.#.......#.#...#.......#................#.
#......#.....#..#......#...#..#.......##.#..#..#........#.##..#.#.......#.#.......#....#........
...................##..###.#.#......#...###...#####..###..##.#.............#.#...#.......#......
.............#..###..#.#..#...#...#.#..##..##.####.##..#..#...#...###........#.##...##......#...
......#.##...###.................##.#.....#.#..........#......#.#.#..........#...#.#.##.##......
.......##...#.###....##....##.#..#.................##..##............#..#......................#
...#.....#.....#.#.##.##..#..#..#............#.........#.....#.........#....#...................
..#......##...##...##....##...#........#.........###.#...#.#..............#....#....#.......#...
.#...#.....#..#........#....#................##.......##...#....#...##.........#.....#..#...#...
#..........###..#.#..#..........##.....##..#..#.......#...........#..#...#.##...#...##.........#
...#.#.#.#....#......#..#...#.#.###....##..######..#...#...........#.#......#..#.#..#.#........#
#.........#...#.....#....###..#....##.#.##..#..#.##...####...#....#........#.##.....#.#.######.#
.....#.#.#......#.#.................#..#.#.......#..#.........#...#..#......##..........#....#..
.##.#.###....##....##...##........#......#..#..#......#........##..........#..#...#.#..#...#.#.#
.........#..#.##..#..#..#...#........#...........#.#......#.#.#....#..........#............#...#
..#...#.........#......##.#..##.#...#...#..##.......#.#....#.#.#....#...........................
#.#...#............#......#..#.......#....#......#....#.#......##...........#...................
#..#.........#.....#.#.........##.#.....#........#..............#...#............#..#....#.....#
...#....#..####.#..##....##....##...#...#....#..#..........#..............##....##..#...........
.........#.....#..#.##..#..#..#...#..#....#..#..##...#.......#....#...#..........#.....#........
#...#.....#...#....#.....#....................#.....##.........#.###..#.##.#..###...#...........
................#...#.#..#....###.##........#...#...#......#........#.###.#..#.##..##..#..#.....
#........#....#...#.......#...##.......#............###.....#...#..#.........#....#.......#..#..
...#..#......#.#.###....##....#####.#.....#....#.#...#...........#...#..#......#......#.#...#...
.##..#..#.##...#.##.#.##..##.#..##.#.....###...#..#...........#.......#.......................##
..#..##....#..#............##......#....#.##........#..............#...........#.....#..........
#..........#...#.##...#..##...#..#.....#..#..##....##..........#.......#.#..##..................
...................##..#.#........#.....#....#....#..##...#..#...#....#.#.....#.#..##.....#...##
.#..............##.......#...#.....#.............#.....#......#..#...#..#.#......#......#.....#.
.##.....#.#...#.....#.#.#............#.....#.#..#...#.#..............#........#......##..#......
..#...#...#.....................##.........#.#.........##........#...#...........#.........##.#.
..#.##...###....##.#####...##......#....###....#......#..#...#....#.....#.#..##......#..........
.#....#.....#..#..#..#..#..##.....###....##.#..###...##....##...#....#.....##...............#..#
...#..#....#......##.............#..##..#####.#..#.##..#.#....##.#.#..##.#...#............##.#..
...#..#......#..#....#..#........#..#....###...#.........#.......#.#.###...###....##....#..#...#
.#...#...##........#............##....#........#.#.......#.#.#.#.#......#..#..##.#.##..#......#.
................#....##..........#..#.......###......#....#....###...#.##.##....#....###..#.....
......#..#.#.##..#....#.......#.#######...##.##.##....#................#.........#.#...........#
.##...#..#...#...#......#..##.....#...#..#.######.#..#...##.##.......#..#...#............#....#.
..#.............#.............#....#...........#............#............#...#.........#......##
..........#........................#...#.....#.......#.......###..#..#..#.##...........###......
.#.#.....#..###.......#.##.#...#........#.#.....#.........#.#.......#........#......#...#.....#.
..#......#....#....#....#....#......#.#.#.............#...#............#.....#.#.........##.#...
.#...#.......#...#...#.....#.#......#####.#.##....##..#.#..##...#..#.............#......#..##...
..#.##...#...#..#.#.....#..#.........#..####..#..#..#..#........#.#...#.#......#....#........##.
#..#......#..#.....#...#.#....##...###.#.......#............#....#.#....#...#.#.......#....#....
.................#......##........#..#.#.#.........#......#......#............#.....#......#....
..#.##.....#......................#......#.......#...#.#.##............#...........#.......#.#..
#.....##.#..........###.....#................##..##..#...#..##.......#.#.#.#..##.....#...#......
.#...##...#.....#..#..#...........#................#.##.#.......#....#...#....#......#....#.....
............##......#........##.#..#.#..##..#..#.........#..........#.#....#..##........#..#.#.#
.....#.#......#.#..##...#...##.#..#.....#....#............#.#..................#.#........#...#.
